%%%%%%%%%%%%%%%%%%%%%%%%%%%                                                                
%%%%%%%%%%%%%%%%%%%%%%%%%%%                                                                
%%%%%%%%%%%%%%%%%%%%%%%%%%%                                                                
%%%%%%%%%%%%%%%%%%%%%%%%%%%                                                                
%%%%%%%%%%%%%%%%%%%%%%%%%%%                                                                
%%%%%%%%%%%%%%%%%%%%%%%%%%%                                                                
%%%%%%%%%%%%%%%%%%%%%%%%%%%                                                                
%%%%%%%%%%%%%%%%%%%%%%%%%%%                                                                
%%%%%%%%%%%%%%%%%%%%%%%%%%%                                                                
%%%%%%%%%%%%%%%%%%%%%%%%%%                                                                 
%%%%%%%%%%%%%%%%%%%%%%%%%%                                                                 
%%%%%%%%%%%%%%%%%%%%%%%%%%                                                                 
%%%%%%%%%%%%%%%%%%%%%%%%%%                                                                 
%%%%%%%%%%%%%%%%%%%%%%%%%%                                                                 
%%%%%%%%%%%%%%%%%%%%%%%%%                                                                  
%%%%%%%%%%%%%%%%%%%%%%%%%                                                                  
%%%%%%%%%%%%%%%%%%%%%%%%%                                                                  
%%%%%%%%%%%%%%%%%%%%%%%%                                                                   
%%%%%%%%%%%%%%%%%%%%%%%%                                                                   
%%%%%%%%%%%%%%%%%%%%%%%%                                                                   
%%%%%%%%%%%%%%%%%%%%%%%                                                                    
%%%%%%%%%%%%%%%%%%%%%%%                                                                    
%%%%%%%%%%%%%%%%%%%%%%%                                                                    
%%%%%%%%%%%%%%%%%%%%%%                                                                     
%%%%%%%%%%%%%%%%%%%%%%                                                                     
%%%%%%%%%%%%%%%%%%%%%%                                                                     
%%%%%%%%%%%%%%%%%%%%%                                                                      
%%%%%%%%%%%%%%%%%%%%%                                          %%  %%                      
%%%%%%%%%%%%%%%%%%%%%                                         %%% %%%                      
%%%%%%%%%%%%%%%%%%%%                                         %%%%%%%%                      
%%%%%%%%%%%%%%%%%%%%                                        %%%%%%%%%                      
%%%%%%%%%%%%%%%%%%%                                        %%%%%%%%%%                      
%%%%%%%%%%%%%%%%%%%                                       %%%%%%%%%%                       
%%%%%%%%%%%%%%%%%%%                                      %%%%%%%%%%%                       
%%%%%%%%%%%%%%%%%%                                      %%%%%%%%%%%                        
%%%%%%%%%%%%%%%%%%                                     %%%%%%%%%%%                         
%%%%%%%%%%%%%%%%%                                     %%%%%%%.%%%%                         
%%%%%%%%%%%%%%%%%                                     %%%%%%.%%%%                          
%%%%%%%%%%%%%%%%%                                    %%%%%%.%.%%                           
%%%%%%%%%%%%%%%%                                    %%%%%%.%.%%                            
%%%%%%%%%%%%%%%%                                    %%%%%%%.%.%                            
%%%%%%%%%%%%%%%                                    %%%%%%..%.%                             
%%%%%%%%%%%%%%%%%%%                                %%%%%%%%.%.                             
%%%%%%%%%%%%%%%%%%%%                              %%%%%%%..%.%                             
%%%%%%%%%%%%%%%%%%%%%                             %%%%%%.%%.%.                             
%%%%%%%%%%%%%%%%%%%%%%                           %%%%%%%%..%.%                             
%%%%%%%%%%%%%%%%%%%%%%                           %%%%%%%.%%.%%                             
%%%%%%%%%%%%%%%%%%%%%%%                          %%%%%%%%..%.                              
%%%%%%%%%%%%%%%%%%%%%%%                         %%%%%%%%.%%.%                              
%%%%%%%%%%%%%%%%%%%%%%%                         %%%%%%%%%..%%                              
%%%%%%%%%%%%%%%%%%%%%%%                        %%%%%%%%%.%%.                              %
%%%%%%%%%%%%%%%%%%%%%%%                        %%%%%%%%%%..%                             %%
%%%%%%%%%%%%%%%%%%%%%%%                        %%%%%%%%%%%%%                            %%%
%%%%%%%%%%%%%%%%%%%%%%%                       %%%%%%%%%%%..                            %%%%
%%%%%%%%%%%%%%%%%%%%%%%                       %%%%%%%%%%%%%                           %%%%%
%%%%%%%%%%%%%%%%%%%%%%%                      %%%%%%%%%% %%%                           %%%%%
%%%%%%%%%%%%%%%%%%%%%%%                      %%%%%%%%%% %%                           %%%%%%
%%%%%%%%%%%%%%%%%%%%%%%                     %%%%%%%%%%%                             %%%%%%%
%%%%%%%%%%%%%%%%%%%%%%%                     %%%%%%%%%%                             %%%%%%%%
%%%%%%%%%%%%%%%%%%%%%%%                     %%%%%%%%%%                             %%%%%%%%
%%%%%%%%%%%%%%%%%%%%%%                     %%%%%%%%%%%                            %%%%%%%%%
%%%%%%%%%%%%%%%%%%%%%%                     %%%%%%%%%%                            %%%%%%%%%%
%%%%%%%%%%%%%%%%%%%%%%                     %%%%%%%%%%                            %%%%%%%%%%
%%%%%%%%%%%%%%%%%%%%%%                    %%%%%%%%%%%                           %%%%%%%%%%%
%%%%%%%%%%%%%%%%%%%%%                     %%%%%%%%%%%                          %%%%%%%%%%%%
%%%%%%%%%%%%%%%%%%%%%                    %%%%%%%%%%%                           %%%%%%%%%%%%
%%%%%%%%%%%%%%%%%%%%%                    %%%%%%%%%%%                          %%%%%%%%%%%%%
%%%%%%%%%%%%%%%%%%%%                     %%%%%%%%%%%                          %%%%%%%%%%%%%
%%%%%%%%%%%%%%%%%%%%                    %%%%%%%%%%%%                         %%%%%%%%%%%%%%
%%%%%%%%%%%%%%%%%%%%                    %%%%%%%%%%%                          %%%%%%%%%%%%%%
%%%%%%%%%%%%%%%%%%%                     %%%%%%%%%%                          %%%%%%%%%%%%%%%
%%%%%%%%%%%%%%%%%%%                    %%%%%%%%%% %                         %%%%%%%%%%%%%%%
%%%%%%%%%%%%%%%%%%%                    %%%%%%%%% %%                        %%%%%%%%%%%%%%%%
%%%%%%%%%%%%%%%%%%                     %%%%%%%% %%                         %%%%%%%%%%%%%%%%
%%%%%%%%%%%%%%%%%%                    %%%%%%%% %%%                        %%%%%%%%%%%%%%%%%
%%%%%%%%%%%%%%%%%                     %%%%%%% %%%%                        %%%%%%%%%%%%%%%%%
%%%%%%%%%%%%%%%%%                     %%%%%% %%%%%                       %%%%%%%%%%%%%%%%%%
%%%%%%%%%%%%%%%%                     %%%%%% %%%%%                        %%%%%%%%%%%%%%%%%%
%%%%%%%%%%%%%%%%                     %%%%% %%%%%%                       %%%%%%%%%%%%%%%%%%%
%%%%%%%%%%%%%%%                      %%%% %%%%%%%                       %%%%%%%%%%%%%%%%%%%
%%%%%%%%%%%%%%%                     %%%% %%%%%%%%                       %%%%%%%%%%%%%%%%%%%
%%%%%%%%%%%%%%                      %%% %%%%%%%%%                      %%%%%%%%%%%%%%%%%%%%
%%%%%%%%%%%%%%                      %% %%%%%%%%%                       %%%%%%%%%%%%%%%%%%%%
%%%%%%%%%%%%%                      %% %%%%%%%%%%                       %%%%%%%%%%%%%%%%%%%%
%%%%%%%%%%%%%                      % %%%%%%%%%%%                      %%%%%%%%%%%%%%%%%%%%%
%%%%%%%%%%%%                      % %% %%%%%%%%%                      %%%%%%%%%%%%%%%%%%%%%
%%%%%%%%%%%%                       %%%%%%%%%%%%                       %%%%%%%%%%%%%%%%%%%%%
%%%%%%%%%%%                       %%%%%%%%%%%%%                      %%%%%%%%%%%%%%%%%%%%%%
%%%%%%%%%%                       %%%% %%%%%%%%%                      %%%%%%%%%%%%%%%%%%%%%%
%%%%%%%%%%                       %%%% %%%%%%%%%                      %%%%%%%%%%%%%%%%%%%%%%
%%%%%%%%%                       %%%% %%%%%%%%%                       %%%%%%%%%%%%%%%%%%%%%%
%%%%%%%%                        %%%% %%%%%%%%%                      %%%%%%%%%%%%%%%%%%%%%%%
%%%%%%%%                        %%%% %%%%%%%%%                      %%%%%%%%%%%%%%%%%%%%%%%
%%%%%%%                        %%%% %%%%%%%%%%                      %%%%%%%%%%%%%%%%%%%%%%%
%%%%%%                         %%%% %%%%%%%%%                       %%%%%%%%%%%%%%%%%%%%%%%
%%%%%                         %%%%  %%%%%%%%%                       %%%%%%%%%%%%%%%%%%%%%%%
%%%%%                         %%%% %%%%%%%%%%                       %%%%%%%%%%%%%%%%%%%%%%%
%%%%                         %%%%  %%%%%%%%%                        %%%%%%%%%%%%%%%%%%%%%%%
%%%                          %%%% %%%%%%%%%%                        %%%%%%%%%%%%%%%%%%%%%%%
%%                          %%%%% %%%%%%%%%%                        %%%%%%%%%%%%%%%%%%%%%%%
%                           %%%%  %%%%%%%%%%                        %%%%%%%%%%%%%%%%%%%%%%%
                           %%%%% %%%%%%%%%%                         %%%%%%%%%%%%%%%%%%%%%%%
                           %%%%  %%%%%%%%%%                         %%%%%%%%%%%%%%%%%%%%%%%
                          %%%%%..%%%%%%%%%                          %%%%%%%%%%%%%%%%%%%%%%%
                         %%%%% .%%%%%%%%%%                           %%%%%%%%%%%%%%%%%%%%%%
                         %%%% ...%%%%%%%%%   P                       %%%%%%%%%%%%%%%%%%%%%%
                        %%%%%..%%%%%%%%%%                             %%%%%%%%%%%%%%%%%%%%%
                        %%%% ....%%%%%%%%                              %%%%%%%%%%%%%%%%%%%%
                        %%%%..%%%%%%%%%%                                %%%%%%%%%%%%%%%%%%%
                       %%%% .....%%%%%%%                                    %%%%%%%%%%%%%%%
                       %%% ..%%%%%%%%%%                                    %%%%%%%%%%%%%%%%
                       %%% .%...%%%%%%%                                    %%%%%%%%%%%%%%%%
                       %%  ..%%%%%%%%%                                    %%%%%%%%%%%%%%%%%
                          %%%...%%%%%                                     %%%%%%%%%%%%%%%%%
                         %%..%%%%%%%%                                     %%%%%%%%%%%%%%%%%
                         %%%%..%%%%%                                     %%%%%%%%%%%%%%%%%%
                        %%%..%%%%%%                                      %%%%%%%%%%%%%%%%%%
                       %%%%%%%%%%%                                      %%%%%%%%%%%%%%%%%%%
                       %%%%%%%%%%                                       %%%%%%%%%%%%%%%%%%%
                      %%%%%%%%%%%                                       %%%%%%%%%%%%%%%%%%%
                      %%%%%%%%%%%                                      %%%%%%%%%%%%%%%%%%%%
                      %%%%%%%%%%%                                      %%%%%%%%%%%%%%%%%%%%
                      %%% %%%%%%%                                     %%%%%%%%%%%%%%%%%%%%%
                      %%  %%%%%%                                      %%%%%%%%%%%%%%%%%%%%%
                           %%%%%                                      %%%%%%%%%%%%%%%%%%%%%
                           %%%%                                      %%%%%%%%%%%%%%%%%%%%%%
                           %%                                        %%%%%%%%%%%%%%%%%%%%%%
                                                                     %%%%%%%%%%%%%%%%%%%%%%
                                                                    %%%%%%%%%%%%%%%%%%%%%%%
                                                                    %%%%%%%%%%%%%%%%%%%%%%%
                                                                    %%%%%%%%%%%%%%%%%%%%%%%
                                                                   %%%%%%%%%%%%%%%%%%%%%%%%
                                                                   %%%%%%%%%%%%%%%%%%%%%%%%
                                                                   %%%%%%%%%%%%%%%%%%%%%%%%
                                                                  %%%%%%%%%%%%%%%%%%%%%%%%%
                                                                  %%%%%%%%%%%%%%%%%%%%%%%%%
                                                                  %%%%%%%%%%%%%%%%%%%%%%%%%
                                                                 %%%%%%%%%%%%%%%%%%%%%%%%%%
                                                                 %%%%%%%%%%%%%%%%%%%%%%%%%%
                                                                 %%%%%%%%%%%%%%%%%%%%%%%%%%
                                                                 %%%%%%%%%%%%%%%%%%%%%%%%%%
                                                                 %%%%%%%%%%%%%%%%%%%%%%%%%%
                                                                %%%%%%%%%%%%%%%%%%%%%%%%%%%
                                                                %%%%%%%%%%%%%%%%%%%%%%%%%%%
                                                                %%%%%%%%%%%%%%%%%%%%%%%%%%%
                                                                %%%%%%%%%%%%%%%%%%%%%%%%%%%
                                                                %%%%%%%%%%%%%%%%%%%%%%%%%%%
                                                                %%%%%%%%%%%%%%%%%%%%%%%%%%%
                                                                %%%%%%%%%%%%%%%%%%%%%%%%%%%
                                                                %%%%%%%%%%%%%%%%%%%%%%%%%%%
                                                                %%%%%%%%%%%%%%%%%%%%%%%%%%%
