%%%%%%%%%%%%                                                                               
%%%%%%%%%%%%%                                                                              
%%%%%%%%%%%%%%                                                                             
%%%%%%%%%%%%%%%                                                                            
%%%%%%%%%%%%%%%                                                                            
%%%%%%%%%%%%%%%%                                                                           
%%%%%%%%%%%%%%%%%                                                                          
%%%%%%%%%%%%%%%%%                                                                          
%%%%%%%%%%%%%%%%%%                                                                         
%%%%%%%%%%%%%%%%%%                                                                         
%%%%%%%%%%%%%%%%%%                                                                         
%%%%%%%%%%%%%%%%%%                                                                         
%%%%%%%%%%%%%%%%%%%                                                                        
%%%%%%%%%%%%%%%%%%%                                                                        
%%%%%%%%%%%%%%%%%%%                                                                        
%%%%%%%%%%%%%%%%%%%                                                                        
%%%%%%%%%%%%%%%%%%%                                                                        
%%%%%%%%%%%%%%%%%%%                                                                        
%%%%%%%%%%%%%%%%%%%                                                                        
%%%%%%%%%%%%%%%%%%%                                                                        
%%%%%%%%%%%%%%%%%%%                                                                        
%%%%%%%%%%%%%%%%%%%                                                                        
%%%%%%%%%%%%%%%%%%%                                                                        
%%%%%%%%%%%%%%%%%%                                                                         
%%%%%%%%%%%%%%%%%%                                                                         
%%%%%%%%%%%%%%%%%%                                                                         
%%%%%%%%%%%%%%%%%%                                                                         
%%%%%%%%%%%%%%%%%%                                                                         
%%%%%%%%%%%%%%%%%%                                                                         
%%%%%%%%%%%%%%%%%                                                                          
%%%%%%%%%%%%%%%%%                                                                          
%%%%%%%%%%%%%%%%%                                                                          
%%%%%%%%%%%%%%%%%                                                                          
%%%%%%%%%%%%%%%%                                 %%%                                       
%%%%%%%%%%%%%%%%                                %%%%                                       
%%%%%%%%%%%%%%%%                               %%%%%                                       
%%%%%%%%%%%%%%%                               %%%%%      %%                                
%%%%%%%%%%%%%%%                              %%%%%%      %%                                
%%%%%%%%%%%%%%%                              %%%%%      %%%                                
%%%%%%%%%%%%%%%                             %%%%%      %%%%                                
%%%%%%%%%%%%%%                             %%%%%%     %%%%                                 
%%%%%%%%%%%%%%                            %%%%%%     %%%%%                                 
%%%%%%%%%%%%%%                            %%%%%      %%%%                                  
%%%%%%%%%%%%%                            %%%%%      %%%%%                                  
%%%%%%%%%%%%%                            %%%%%     %%%%%                                   
%%%%%%%%%%%%%                           %%%%%      %%%%   %%                               
%%%%%%%%%%%%                            %%%%%     %%%%%   %%                               
%%%%%%%%%%%%                           %%%%%      %.%%   %%%                               
%%%%%%%%%%%%                           %%%%%     %.%%   %%%                                
%%%%%%%%%%%                           %%%%%      %%.%   %%%                                
%%%%%%%%%%%                           %%%%%     %..%   %%%                                 
%%%%%%%%%%%                           %%%%      %%%.   %%%                                 
%%%%%%%%%%                           %%%%%     %%..%  %%%                                  
%%%%%%%%%%                           %%%%      %.%%.  %%%                                  
%%%%%%%%%                            %%%%      %%..% %%%                                   
%%%%%%%%%                           %%%%%     %%.%%. %%%                                   
%%%%%%%%%                           %%%%      %%%..%%%%                                    
%%%%%%%%                            %%%%      %%.%% %%%                                    
%%%%%%%%                            %%%%     %%%%.. %%%                                    
%%%%%%%%                            %%%      %%%.%% %%                                     
%%%%%%%                            %%%%      %%%%.% %%                                     
%%%%%%%                            %%%%      %%%%%  %                                      
%%%%%%                             %%%%     %%%%%%  %                                      
%%%%%%                             %%%      %%% %  %                                       
%%%%%%                            %%%%      %%%    %                                       
%%%%%                             %%%%      %%%    %                                       
%%%%%                             %%%%     %%%%    %                                       
%%%%%                             %%%      %%%    %%                                       
%%%%                              %%%      %%%    %%                                       
%%%%                              %%%      %%%    %%                                       
%%%                              %%%%     %%%% % %%%                                       
%%%                              %%%      %%%  %%%%                                        
%%%                              %%%      %%%  %%%%                                        
%%                               %%%      %%% %%%%%                                        
%%                               %%%      %%% %%%%%                                        
%                                %%%     %%%  %%%%                                         
%                               %%%%     %%% %%%%%                                         
%                               %%%      %%% %%%%%                                         
                                %%%      %%% %% %                                          
                                %%%     %%% %%                                             
                                %%%     %%% % %                                            
                                %%%     %%%  %%                                            
                               %%%%     %%% %%                                             
                               %%%      %% %%%                                            %
                               %%%     %%  %%%                                            %
                               %%%     % % %%                                             %
                               %%%      %%%%%                                            %%
                              %%%%     %%%%%%                                            %%
                              %%%%    %%%%%%                                            %%%
P                             %%%     %%%%%%                                            %%%
                              %%%     %%%%%%                                            %%%
                              %%%     %%%%%                                            %%%%
                             %%%%    %%%%%%                                            %%%%
                             %%%     %%%%%%                                           %%%%%
                             %%      %%%%%                                            %%%%%
                             % %     %%%%%                                            %%%%%
                              %%    %%%%%%                                           %%%%%%
                             %%%    %%%%%                                            %%%%%%
                            %%%%    %%%%%                                            %%%%%%
                            %%%    %%%%%%                                           %%%%%%%
                            %%%    %%%%%                                            %%%%%%%
                           %%%%    %%%%%                                           %%%%%%%%
                           %%%%   %%%%%%                                           %%%%%%%%
                           %%%%   %%%%%                                            %%%%%%%%
                          %%%.    %%%%%                                           %%%%%%%%%
                          %%.%   %%%%%                                            %%%%%%%%%
                          %%%.   %%%%%                                            %%%%%%%%%
                         %%..%   %%%%                                            %%%%%%%%%%
                         %%%%.  %%%%%                                            %%%%%%%%%%
                        %%...%  %%%%                                            %%%%%%%%%%%
                        %%%%%. %%%%%                                            %%%%%%%%%%%
                        %%...% %%%%                                             %%%%%%%%%%%
                       %%%%%% %%%%%                                            %%%%%%%%%%%%
                       %%%... %%%%                                             %%%%%%%%%%%%
                      %%%%%%% %%%                                              %%%%%%%%%%%%
                     %%%%%... %%%                                             %%%%%%%%%%%%%
                     %%%%%%%% %%                                              %%%%%%%%%%%%%
                    %%%%% .%  %%                                              %%%%%%%%%%%%%
                   %%%%%% %  %%                                              %%%%%%%%%%%%%%
                   %%%%%  %  %                                               %%%%%%%%%%%%%%
                  %%%%%% %   %                                               %%%%%%%%%%%%%%
                 %%%%%%  %  %%                                              %%%%%%%%%%%%%%%
                %%%%%%  %% %%%                                              %%%%%%%%%%%%%%%
                %%%%%   %%%%%%                                              %%%%%%%%%%%%%%%
               %%%%%    %%%%%                                               %%%%%%%%%%%%%%%
               %%%%       %%%                                              %%%%%%%%%%%%%%%%
               %%%        %%%                                              %%%%%%%%%%%%%%%%
               %%         %%%                                              %%%%%%%%%%%%%%%%
               %          %                                               %%%%%%%%%%%%%%%%%
                                                                          %%%%%%%%%%%%%%%%%
                                                                          %%%%%%%%%%%%%%%%%
                                                                          %%%%%%%%%%%%%%%%%
                                                                         %%%%%%%%%%%%%%%%%%
                                                                         %%%%%%%%%%%%%%%%%%
                                                                         %%%%%%%%%%%%%%%%%%
                                                                         %%%%%%%%%%%%%%%%%%
                                                                         %%%%%%%%%%%%%%%%%%
                                                                         %%%%%%%%%%%%%%%%%%
                                                                        %%%%%%%%%%%%%%%%%%%
                                                                        %%%%%%%%%%%%%%%%%%%
                                                                        %%%%%%%%%%%%%%%%%%%
                                                                        %%%%%%%%%%%%%%%%%%%
                                                                        %%%%%%%%%%%%%%%%%%%
                                                                        %%%%%%%%%%%%%%%%%%%
                                                                        %%%%%%%%%%%%%%%%%%%
                                                                        %%%%%%%%%%%%%%%%%%%
                                                                        %%%%%%%%%%%%%%%%%%%
                                                                        %%%%%%%%%%%%%%%%%%%
                                                                        %%%%%%%%%%%%%%%%%%%
                                                                         %%%%%%%%%%%%%%%%%%
                                                                         %%%%%%%%%%%%%%%%%%
                                                                         %%%%%%%%%%%%%%%%%%
                                                                         %%%%%%%%%%%%%%%%%%
                                                                          %%%%%%%%%%%%%%%%%
                                                                          %%%%%%%%%%%%%%%%%
                                                                           %%%%%%%%%%%%%%%%
                                                                            %%%%%%%%%%%%%%%
                                                                            %%%%%%%%%%%%%%%
                                                                             %%%%%%%%%%%%%%
                                                                              %%%%%%%%%%%%%
                                                                               %%%%%%%%%%%%
