%%%%%%%%%%%%                                                                               
%%%%%%%%%%%%%                                                                              
%%%%%%%%%%%%%                                                                              
%%%%%%%%%%%%%%                                                                             
%%%%%%%%%%%%%%                                                                             
%%%%%%%%%%%%%%                                                                             
%%%%%%%%%%%%%%%                                                                            
%%%%%%%%%%%%%%%                                                                            
%%%%%%%%%%%%%%%                                                                            
%%%%%%%%%%%%%%%                                                                            
%%%%%%%%%%%%%%%                                                                            
%%%%%%%%%%%%%%%                                                                            
%%%%%%%%%%%%%%%                                                                            
%%%%%%%%%%%%%%%                                                                            
%%%%%%%%%%%%%%%                                                                            
%%%%%%%%%%%%%%%                                                                            
%%%%%%%%%%%%%%%                                                                            
%%%%%%%%%%%%%%%                                                                            
%%%%%%%%%%%%%%%                                                                            
%%%%%%%%%%%%%%%                                                                            
%%%%%%%%%%%%%%%                                                                            
%%%%%%%%%%%%%%%                                                                            
%%%%%%%%%%%%%%%                                                                            
%%%%%%%%%%%%%%%                                                                            
%%%%%%%%%%%%%%%                                                                            
%%%%%%%%%%%%%%%                                                                            
%%%%%%%%%%%%%%%                                                                            
%%%%%%%%%%%%%%                                                                             
%%%%%%%%%%%%%%                                                                             
%%%%%%%%%%%%%%                                                                             
%%%%%%%%%%%%%%                                                                             
%%%%%%%%%%%%%%                                                                             
%%%%%%%%%%%%%                                                                              
%%%%%%%%%%%%%                                                          %%%                 
%%%%%%%%%%%%%                                                          %%%                 
%%%%%%%%%%%%%                                                         %%%%                 
%%%%%%%%%%%%                                                         %%%%%                 
%%%%%%%%%%%%                                                        %%%%%%                 
%%%%%%%%%%%%                                                 %%     %%%%%%                 
%%%%%%%%%%%%                                                 %%%   %%%%%%                  
%%%%%%%%%%%                                                 %%%%   %%%%%%                  
%%%%%%%%%%%                                                %%%%%  %%%%%%%                  
%%%%%%%%%%%                                                %%%%   %%%%%%                   
%%%%%%%%%%%                                               %%%%%  %%%%%%%                   
%%%%%%%%%%                                                %%%%%  %%%%%%                    
%%%%%%%%%%                                                %%%%%  %%%%%%                    
%%%%%%%%%%                                               %%%%%  %%%%%%                     
%%%%%%%%%                                      %         %%%%%  %%%%%%                     
%%%%%%%%%                                     %%        %%%%%%  %%%%%%                     
%%%%%%%%%                                     %%        %%%%%  %%%%%%                      
%%%%%%%%%                                    %%%        %%%%%  %%%%%%                      
%%%%%%%%                                     %%%       %%%%%   %%%%%                       
%%%%%%%%                                    %%%%       %%%%%  %%%%%%                       
%%%%%%%%                                    %%%     . %%%%%%  %%%%%                        
%%%%%%%                                    %%%%    .. %%%%%   %%%%                         
%%%%%%%                                    %%%%    .. %%%%%   %%% %                        
%%%%%%%                                    %%%%   ... %%%%   %%% %%                        
%%%%%%                                    %%%%    ...%%%%%   %% %%                         
%%%%%%                                    %%%%    ...%%%%%   % %%%                         
%%%%%%                                    %%%%   ... %%%%     %%%%                         
%%%%%                                    %%%%    ...%%%%%    %%%%                          
%%%%%                                    %%%%   ....%%%%%   %%%%%                          
%%%%%                                    %%%%   ....%%%%%   %%%%%                          
%%%%                                    %%%%    ... %%%%    %%%%%                          
%%%%                                    %%%%   ....%%%%%    %%%%                           
%%%%                                    %%%%   ....%%%%    %%%%%                           
%%%                                    %%%%    ... %%%     %%%%%                           
%%%                                    %%%%   .... %% %    %%%%%                           
%%%                                    %%%%   ....%% %%    %%%%%                           
%%                                    %%%%    ... % %%%    %%%%                            
%%                                    %%%%   ....  %%%    %%%%%                            
%%                                    %%%%   .... %%%%    %%%%%                            
%                                    %%%%    ... %%%%%    %%%%%                            
%                                    %%%%   .... %%%%%    %%%%                             
%                                    %%%%   .... %%%%     %%%%                             
                                    %%%%    ...  %%%%     %%%%                             
                                    %%%%   ....  %%%%    %%%%%                            %
                                    %%%%   .... %%%%%    %%%%%                            %
                                    %%%%   ...  %%%%     %%%%%                            %
                                   %%%%   ....  %%%%     %%%%                            %%
                                   %%%%   ....  %%%%    %%%%%                            %%
                                   %%%%   ...  %%%%%    %%%%%                            %%
                                  %%%%   ....  %%%%     %%%%%                           %%%
                                  %%%    ....  %%%%     %%%%%                           %%%
                                  %% %   ...  %%%%%     %%%%                            %%%
                                 %% %   ....  %%%%%    %%%%%                           %%%%
                                 % %%   ....  %%%%     %%%%%                           %%%%
                                  %%%   ...   %%%%     %%%%%                           %%%%
                                 %%%   ....  %%%%%     %%%%%                          %%%%%
                                %%%%   ....  %%%%%    %%%%%                           %%%%%
                                %%%%   ...   %%%%     %%%%%                           %%%%%
                               %%%%    ...  %%%%%     %%%%%                          %%%%%%
                               %%%%   ...   %%%%%     %%%%%                          %%%%%%
                               %%%%   ...   %%%%%    %%%%%                           %%%%%%
                              %%%%    ...  %%%%%     %%%%%                          %%%%%%%
                              %%%%    ..   %%%%%     %%%%%                          %%%%%%%
                              %%%%    ..   %%%%%    %%%%%%                          %%%%%%%
                             %%%%     .   %%%%%     %%%%%                          %%%%%%%%
                             %%%%         %%%%%     %%%%%                          %%%%%%%%
                             %%%         %%%%%%    %%%%%%                          %%%%%%%%
                             %%%         %%%%%     %%%%%%                         %%%%%%%%%
                             %%          %%%%%    %%%%%%                          %%%%%%%%%
                             %%         %%%%%%    %%%%%%                          %%%%%%%%%
                             %          %%%%%     %%%%%%                          %%%%%%%%%
                                        %%%%%    %%%%%%                          %%%%%%%%%%
                                       %%%%% P   %%%%%%                          %%%%%%%%%%
                                       %%%%%    %%%%%%%                          %%%%%%%%%%
                                       %%%%     %%%%%%                          %%%%%%%%%%%
                                       %%%%    %%%%%%%                          %%%%%%%%%%%
                                      %%%%     %%%%%%                           %%%%%%%%%%%
                                      %%%%     %%%%%%                           %%%%%%%%%%%
                                      %%%     %%%%%%                           %%%%%%%%%%%%
                                      %%%     %%%%%%                           %%%%%%%%%%%%
                                              %%%%%                            %%%%%%%%%%%%
                                              %%%%                             %%%%%%%%%%%%
                                              %%%%                            %%%%%%%%%%%%%
                                              %%%                             %%%%%%%%%%%%%
                                              %%                              %%%%%%%%%%%%%
                                                                              %%%%%%%%%%%%%
                                                                             %%%%%%%%%%%%%%
                                                                             %%%%%%%%%%%%%%
                                                                             %%%%%%%%%%%%%%
                                                                             %%%%%%%%%%%%%%
                                                                             %%%%%%%%%%%%%%
                                                                            %%%%%%%%%%%%%%%
                                                                            %%%%%%%%%%%%%%%
                                                                            %%%%%%%%%%%%%%%
                                                                            %%%%%%%%%%%%%%%
                                                                            %%%%%%%%%%%%%%%
                                                                            %%%%%%%%%%%%%%%
                                                                            %%%%%%%%%%%%%%%
                                                                            %%%%%%%%%%%%%%%
                                                                            %%%%%%%%%%%%%%%
                                                                            %%%%%%%%%%%%%%%
                                                                            %%%%%%%%%%%%%%%
                                                                            %%%%%%%%%%%%%%%
                                                                            %%%%%%%%%%%%%%%
                                                                            %%%%%%%%%%%%%%%
                                                                            %%%%%%%%%%%%%%%
                                                                            %%%%%%%%%%%%%%%
                                                                            %%%%%%%%%%%%%%%
                                                                            %%%%%%%%%%%%%%%
                                                                            %%%%%%%%%%%%%%%
                                                                            %%%%%%%%%%%%%%%
                                                                            %%%%%%%%%%%%%%%
                                                                             %%%%%%%%%%%%%%
                                                                             %%%%%%%%%%%%%%
                                                                             %%%%%%%%%%%%%%
                                                                              %%%%%%%%%%%%%
                                                                              %%%%%%%%%%%%%
                                                                               %%%%%%%%%%%%
